*********************************
*    *         *          *     *
*    *    *    *     *    *  ** *
*    *    *    *     *    *     *
*    *    *    *     *    *   ***
*    *    *    *     *    *    E*
*    *    *          *    *   ***
*    *    *    *     *    *     *
*S        *    *     *          *
*********************************